000000000000000000000000000000000000000000000001333333333333310000000000000000000000000000000000000000000000000000000000000000000000000000000000
00000000000000000000000000000000000000000000000100000000A00001000000000000000000000000000000000A000000000000000000000000000000000000000000000000
00000000000000000000000000000000000000000000000000000000000001000000000000000000000000000A000001000000000000000000000000000001100000000000K00000
000000000000000000000000000000000000A00000000000000000000000010000000000000000000000000000000000000000000000000000000000000011100000100000000000
000000000000000000000000000000000000100000000000000000100000010000000000000000000000000000000A00000000000000000000000000000111100000000000000000
0000000000000000000000000000000A000000000000000100A00010000001000000000000000000000000000000010000000000A000000000000000001111100000000000000000
000000A000000000000000000A0000010000000000L00001000000100000000000000000000000000000000000000000000A00000000000000000000011111100000000000000000
00000110000000000000P00011100000000000000010000100000010000A0000000000000000000000000000b1000000000100000000000000000000111111100000000000000000
0000000000000P00000000000000000000000000000000010000001000000000000000p0000000000p00000000000000000000000000P000000P0001111111100000000000000E00
60000000001000000000001B0000000000060000000000014444441444444440000000060144400000001000000000000000000010M1NOA60A000A11111111100000000000000000