100000000000000000000100000000000000000000000000000000000000000000000000000000000000000000000000000000000000
100000000000000000G00100000000000000000000000000000000000000000000000000000000000000000000000000000000000000
100000000000000000000100000000000000000000000000000000000000000000000000000000000000000000000000000000000000
100000000000000000000100000000000000000000000000000000000000000000000000000000000000000000000000000000000000
100000001000000000011100000000000000000000000000000000111000000000001100000000000000000000000000000000000K00
100110000000000000000100000000000000000000000000110000000000001100000000000000000000000000000000000001111111
100000000000000010000100000000000000000000110000000000000000000000000000000000000000000000000000000000000000
100000110000000000000100000001100000000000000000000000000000000000000000000000000000000000000000001000000000
100000000000000000001110000000000000001000000000000000000000000000000000000000000000000000110000000000000000
1F000000000000000001010000000000000F00000000000000000000000000000000000F0000000000000F0000000000000000F0000F