000000000000000000000000000000000000000000000000000000000000000000000000000000000000000000000000000000000000000000000000000000000000000000000000
000000000010000000000000000000000000000000000000000000000000000000000000000000000000000000000000000000000000000000000000000000000000000000000000
000000000010000000000000000000000000000000000000000000000000000000000000000000000000000000000000000000000000000000000000000000000000000000K00000
000000000010000010000000000000000000000000000000000000000000000000000000000000000000000000000000000000000000111000000000000000000000000100000000
000000000010000010000000000000100000000000000000000000000000000000000000000000000000000000000000000000000000333000000000000000000000001100000000
0000000000100000000B0000000000100000000000000000000000000000000000000000000000000000000000000000000000000000000000000000000000000000011100000000
000000000000000000010000000000100000000000000000000000000000000000001000011111000000000000000000000000000000000000000000000000000000B11100000000
000000000000000000000000000000100000000000000000000000000000000001000000000000044000000000000000000000000000000000000000000000000001111100000000
0000L00000100000000000000000000000000001000000H00P000000000P0000000B00000000000000000010000000P00000P0000P000000000P00000000000000111111000000E0
V0000000001000000000000000000B00000000010000000000000000000000444444000VVVVVVVVVVV0000100000000000000000000V044000000000044000000B11111100000000