000000000000000000000000000000000000000000000001333333333333310000000000000000000000000000000000000000000000000000000000000000000000000000000000000000000000
000000000000000000000000000000000000000000000001AA000000A00A01000000000000000000000000000000000A000000000000000000000000000000000000000000000000000000000000
00000000000000000000000000000000000000000000000000000000000001000000000000000000000000000A00000100000000000000000000000000000000000000000000S000000000000000
000000000000000000000000000000000000A00000000000000000A000000100000000000000000000000000000000000000000000000000000000000000AAAAAAAAA000000110000000K0000000
000000000000000000000000000000000000100000000000000000100000010000000000000000000000000000000A00000000000000000000000000000011111111100000111000000000000000
0000000000000000000000000000000A000000000000000100A0001A000001000000000000000000000000000000010000000000A000000000000000000033333333300001111000000000000000
000000A000000000000000000A0000010000000000L000010000A010A000000000000000000000000000000000000000000A00000000000000000000000000000000000011111000000000000000
000001100000000P0000P0001110000000000000001000010A000010000A0000000000000000000000000000b1000000000100000000000000000000000000000000000111111000000000000000
0000000000000Pt00p000000000000000000000000000001000000100A0000000p0000p0000000P00t0p000000000000000000000000P00pt00P0000000pppppppppp01111111000000000E00000
60000000001000000000001B0000000000060000000000014444441444444440000000060144400000001000000000000000000010M1NOA60A000A14444AAAAAAAAAA11111111000600000000000