00000000000000000000000000000000000000000000000000000000000000000000000000000333333333330000000000000000000000001g00000000000000000000000000000000
00000000000000000000000000000000000000000000000000000000000000000000100000000000000000000000000000000000000000001000000000000000000000000000000000
00000000000000000000000000000000000000000000000000000000000000000000000000000000000000000000000000000000000000001110000000000000000000000000K00000
000000000000000000000000000000000000000AAA00000000000000000000001000000000000444444444440000000000000000000000000000000111000000000000000000000000
0000000000000000000000000000000000AA000AAA000000000000100000000000000000000001AAAAAAAAA10000000000000000000000000000000333000000000000000000000001
0000000000000000000000000000000000AA000AAA000000000000000000000000000000000001AAAAAAAAA10000000000000000000000000000000000000000000000011100000000
0000000000000000000000000000000000AA000AAA0000000000000000000010000000000L0001AAAAAAAAA10000000000000000000000000000000000000000000000B11100000000
0000000000000000000t00t00000000000AA000AAA000000000100000000000000000000010001AAAAAAAAA10000000000000000000000000000000000000000000001111100000000
ppP0P0Pp00P0pP00ptp0Pt00p000000000AA000AAA0000000000000000B1000000000000000001AAAAAAAAA000000000000000000000000000000000000000000000111111000000E0
V0000AAAAAAAAAA1AAAAAAAAA1004AA444AA444AAA14444AA4B0000000000000000000000VVVV1VVVSVV0000000000S444444S44S4444S44444V000000044000000B11111100000000